%%%%%%%%%%%%
%***&&&&***%
%$********$%
%**********%
%**********%
%&********&%
%&********&%
%**********%
%**********%
%****$$****%
%$**&&&&**$%
%%%%%%%%%%%%
