%%%%%%%%%%%%
%*$******$*%
%**&****&**%
%*********&%
%**********%
%**********%
%$********$%
%**********%
%&*********%
%**&****&**%
%*$******$*%
%%%%%%%%%%%%
