%%%%%%%%%%%%
%*&******&*%
%**$****$**%
%**********%
%**********%
%****%%***&%
%****%%****%
%**********%
%**********%
%**$****$**%
%*&******&*%
%%%%%%%%%%%%
